APMRegistryErrorHandle2.sol	 killed 
APMRegistryErrorHandle4.sol	 killed 
APMRegistryErrorHandle6.sol	 killed 
APMRegistryEventDelMut1.sol	 killed 
APMRegistryFunctionVisMut10.sol	 live 
APMRegistryFunctionVisMut11.sol	 live 
APMRegistryFunctionVisMut13.sol	 live 
APMRegistryFunctionVisMut14.sol	 live 
APMRegistryFunctionVisMut16.sol	 live 
APMRegistryFunctionVisMut17.sol	 live 
APMRegistryFunctionVisMut3.sol	 live 
APMRegistryFunctionVisMut4.sol	 killed 
APMRegistryFunctionVisMut5.sol	 killed 
APMRegistryFunctionVisMut6.sol	 live 
APMRegistryFunctionVisMut9.sol	 live 
APMRegistryModifierAddMut6.sol	 killed 
APMRegistryModifierAddMut7.sol	 killed 
APMRegistryModifierAddMut8.sol	 killed 
APMRegistryModifierDelMut1.sol	 live 
APMRegistryStateVarMut1.sol	 live 
APMRegistryStateVarMut10.sol	 live 
APMRegistryStateVarMut11.sol	 live 
APMRegistryStateVarMut12.sol	 live 
APMRegistryStateVarMut13.sol	 live 
APMRegistryStateVarMut14.sol	 live 
APMRegistryStateVarMut15.sol	 killed 
APMRegistryStateVarMut16.sol	 killed 
APMRegistryStateVarMut3.sol	 live 
APMRegistryStateVarMut5.sol	 live 
APMRegistryStateVarMut9.sol	 live 
Live: 19
Killed: 11
Total: 30
Mutation Score: 0.36666666666666664
