ProjectWithBondsAssignmentMut1.sol	 killed 
ProjectWithBondsAssignmentMut10.sol	 live 
ProjectWithBondsAssignmentMut100.sol	 killed 
ProjectWithBondsAssignmentMut101.sol	 killed 
ProjectWithBondsAssignmentMut102.sol	 live 
ProjectWithBondsAssignmentMut103.sol	 killed 
ProjectWithBondsAssignmentMut104.sol	 killed 
ProjectWithBondsAssignmentMut11.sol	 killed 
ProjectWithBondsAssignmentMut12.sol	 killed 
ProjectWithBondsAssignmentMut13.sol	 live 
ProjectWithBondsAssignmentMut14.sol	 killed 
ProjectWithBondsAssignmentMut15.sol	 killed 
ProjectWithBondsAssignmentMut16.sol	 live 
ProjectWithBondsAssignmentMut2.sol	 live 
ProjectWithBondsAssignmentMut3.sol	 killed 
ProjectWithBondsAssignmentMut33.sol	 killed 
ProjectWithBondsAssignmentMut34.sol	 live 
ProjectWithBondsAssignmentMut35.sol	 killed 
ProjectWithBondsAssignmentMut36.sol	 killed 
ProjectWithBondsAssignmentMut37.sol	 live 
ProjectWithBondsAssignmentMut38.sol	 killed 
ProjectWithBondsAssignmentMut39.sol	 killed 
ProjectWithBondsAssignmentMut4.sol	 killed 
ProjectWithBondsAssignmentMut40.sol	 live 
ProjectWithBondsAssignmentMut5.sol	 live 
ProjectWithBondsAssignmentMut57.sol	 killed 
ProjectWithBondsAssignmentMut58.sol	 killed 
ProjectWithBondsAssignmentMut59.sol	 killed 
ProjectWithBondsAssignmentMut6.sol	 killed 
ProjectWithBondsAssignmentMut60.sol	 killed 
ProjectWithBondsAssignmentMut61.sol	 live 
ProjectWithBondsAssignmentMut62.sol	 live 
ProjectWithBondsAssignmentMut63.sol	 killed 
ProjectWithBondsAssignmentMut64.sol	 killed 
ProjectWithBondsAssignmentMut65.sol	 killed 
ProjectWithBondsAssignmentMut66.sol	 live 
ProjectWithBondsAssignmentMut67.sol	 killed 
ProjectWithBondsAssignmentMut68.sol	 killed 
ProjectWithBondsAssignmentMut69.sol	 live 
ProjectWithBondsAssignmentMut7.sol	 killed 
ProjectWithBondsAssignmentMut70.sol	 killed 
ProjectWithBondsAssignmentMut71.sol	 killed 
ProjectWithBondsAssignmentMut72.sol	 live 
ProjectWithBondsAssignmentMut73.sol	 killed 
ProjectWithBondsAssignmentMut74.sol	 killed 
ProjectWithBondsAssignmentMut75.sol	 killed 
ProjectWithBondsAssignmentMut76.sol	 killed 
ProjectWithBondsAssignmentMut77.sol	 killed 
ProjectWithBondsAssignmentMut78.sol	 killed 
ProjectWithBondsAssignmentMut79.sol	 killed 
ProjectWithBondsAssignmentMut8.sol	 live 
ProjectWithBondsAssignmentMut80.sol	 killed 
ProjectWithBondsAssignmentMut89.sol	 live 
ProjectWithBondsAssignmentMut9.sol	 killed 
ProjectWithBondsAssignmentMut90.sol	 killed 
ProjectWithBondsAssignmentMut91.sol	 killed 
ProjectWithBondsAssignmentMut92.sol	 killed 
ProjectWithBondsAssignmentMut93.sol	 killed 
ProjectWithBondsAssignmentMut94.sol	 live 
ProjectWithBondsAssignmentMut95.sol	 killed 
ProjectWithBondsAssignmentMut96.sol	 killed 
ProjectWithBondsAssignmentMut97.sol	 live 
ProjectWithBondsAssignmentMut98.sol	 killed 
ProjectWithBondsAssignmentMut99.sol	 killed 
ProjectWithBondsBinMut1.sol	 killed 
ProjectWithBondsBinMut10.sol	 live 
ProjectWithBondsBinMut11.sol	 killed 
ProjectWithBondsBinMut12.sol	 killed 
ProjectWithBondsBinMut13.sol	 live 
ProjectWithBondsBinMut14.sol	 killed 
ProjectWithBondsBinMut15.sol	 live 
ProjectWithBondsBinMut16.sol	 killed 
ProjectWithBondsBinMut17.sol	 live 
ProjectWithBondsBinMut18.sol	 killed 
ProjectWithBondsBinMut19.sol	 live 
ProjectWithBondsBinMut2.sol	 live 
ProjectWithBondsBinMut20.sol	 killed 
ProjectWithBondsBinMut3.sol	 live 
ProjectWithBondsBinMut4.sol	 killed 
ProjectWithBondsBinMut5.sol	 killed 
ProjectWithBondsBinMut6.sol	 killed 
ProjectWithBondsBinMut7.sol	 live 
ProjectWithBondsBinMut8.sol	 killed 
ProjectWithBondsBinMut9.sol	 killed 
ProjectWithBondsErrorHandle1.sol	 live 
ProjectWithBondsErrorHandle2.sol	 killed 
ProjectWithBondsErrorHandle3.sol	 live 
ProjectWithBondsErrorHandle4.sol	 live 
ProjectWithBondsErrorHandle5.sol	 live 
ProjectWithBondsErrorHandle6.sol	 live 
ProjectWithBondsErrorHandle7.sol	 live 
ProjectWithBondsErrorHandle8.sol	 live 
ProjectWithBondsEventDelMut1.sol	 live 
ProjectWithBondsEventDelMut2.sol	 live 
ProjectWithBondsEventDelMut3.sol	 live 
ProjectWithBondsFunctionTypeMut2.sol	 killed 
ProjectWithBondsFunctionTypeMut4.sol	 killed 
Live: 36
Killed: 61
Total: 97
Mutation Score: 0.6288659793814433
ProjectWithBondsFunctionTypeMut6.sol	 killed 
ProjectWithBondsFunctionTypeMut8.sol	 killed 
ProjectWithBondsFunctionVisMut1.sol	 killed 
ProjectWithBondsFunctionVisMut12.sol	 live 
ProjectWithBondsFunctionVisMut13.sol	 live 
ProjectWithBondsFunctionVisMut14.sol	 live 
ProjectWithBondsFunctionVisMut18.sol	 live 
ProjectWithBondsFunctionVisMut19.sol	 killed 
ProjectWithBondsFunctionVisMut20.sol	 killed 
ProjectWithBondsFunctionVisMut21.sol	 live 
ProjectWithBondsFunctionVisMut22.sol	 killed 
ProjectWithBondsFunctionVisMut23.sol	 killed 
ProjectWithBondsFunctionVisMut24.sol	 live 
ProjectWithBondsFunctionVisMut6.sol	 live 
ProjectWithBondsStateVarMut1.sol	 live 
ProjectWithBondsStateVarMut2.sol	 live 
ProjectWithBondsStateVarMut3.sol	 killed 
ProjectWithBondsStateVarMut4.sol	 killed 
ProjectWithBondsStateVarMut5.sol	 live 
ProjectWithBondsStateVarMut6.sol	 live 
ProjectWithBondsStateVarMut7.sol	 live 
ProjectWithBondsStateVarMut8.sol	 live 
Live: 13
Killed: 9
Total: 22
Mutation Score: 0.4090909090909091
