Live: 0
Killed: 0
Total: 0
Mutation Score: NaN
EVMScriptRunnerAddressRand2.sol	 killed 
EVMScriptRunnerAddressRand4.sol	 killed 
EVMScriptRunnerAddressRand6.sol	 killed 
EVMScriptRunnerAddressRand8.sol	 killed 
EVMScriptRunnerAddressZero1.sol	 killed 
EVMScriptRunnerAddressZero3.sol	 live 
EVMScriptRunnerAddressZero5.sol	 killed 
EVMScriptRunnerAddressZero7.sol	 killed 
EVMScriptRunnerErrorHandle10.sol	 killed 
EVMScriptRunnerErrorHandle11.sol	 killed 
EVMScriptRunnerErrorHandle15.sol	 live 
EVMScriptRunnerErrorHandle16.sol	 live 
EVMScriptRunnerErrorHandleAssertInsert13.sol	 live 
EVMScriptRunnerErrorHandleAssertInsert2.sol	 live 
EVMScriptRunnerErrorHandleAssertInsert5.sol	 live 
EVMScriptRunnerErrorHandleAssertInsert8.sol	 live 
EVMScriptRunnerErrorHandleReqInsert1.sol	 live 
EVMScriptRunnerErrorHandleReqInsert12.sol	 live 
EVMScriptRunnerErrorHandleReqInsert4.sol	 live 
EVMScriptRunnerErrorHandleReqInsert7.sol	 live 
EVMScriptRunnerErrorHandleRevertInsert14.sol	 live 
EVMScriptRunnerErrorHandleRevertInsert3.sol	 live 
EVMScriptRunnerErrorHandleRevertInsert6.sol	 live 
EVMScriptRunnerErrorHandleRevertInsert9.sol	 live 
EVMScriptRunnerEventDelMut1.sol	 killed 
EVMScriptRunnerFunctionTypeDel2.sol	 killed 
EVMScriptRunnerFunctionTypeDel4.sol	 killed 
EVMScriptRunnerFunctionTypeDel6.sol	 live 
EVMScriptRunnerFunctionTypeSwap5.sol	 live 
EVMScriptRunnerModifierDelMut1.sol	 live 
EVMScriptRunnerModifierDelMut2.sol	 live 
EVMScriptRunnerSelfdestructInsert1.sol	 live 
EVMScriptRunnerSelfdestructInsert2.sol	 live 
EVMScriptRunnerSelfdestructInsert3.sol	 live 
EVMScriptRunnerStateVarMut1.sol	 live 
EVMScriptRunnerStateVarMut2.sol	 live 
EVMScriptRunnerStateVarMut3.sol	 live 
EVMScriptRunnerStateVarMut4.sol	 live 
EVMScriptRunnerStateVarMut5.sol	 live 
EVMScriptRunnerStateVarMut6.sol	 live 
Live: 28
Killed: 12
Total: 40
Mutation Score: 0.3
