ACLAbstractContract1.sol	 killed 
ACLAbstractContract10.sol	 killed 
ACLAbstractContract11.sol	 killed 
ACLAbstractContract12.sol	 killed 
ACLAbstractContract13.sol	 killed 
ACLAbstractContract14.sol	 killed 
ACLAbstractContract15.sol	 killed 
ACLAbstractContract16.sol	 killed 
ACLAbstractContract17.sol	 killed 
ACLAbstractContract18.sol	 killed 
ACLAbstractContract19.sol	 killed 
ACLAbstractContract2.sol	 killed 
ACLAbstractContract20.sol	 killed 
ACLAbstractContract21.sol	 killed 
ACLAbstractContract22.sol	 killed 
ACLAbstractContract23.sol	 killed 
ACLAbstractContract24.sol	 killed 
ACLAbstractContract25.sol	 killed 
ACLAbstractContract26.sol	 killed 
ACLAbstractContract3.sol	 killed 
ACLAbstractContract4.sol	 killed 
ACLAbstractContract5.sol	 killed 
ACLAbstractContract6.sol	 killed 
ACLAbstractContract7.sol	 killed 
ACLAbstractContract8.sol	 killed 
ACLAbstractContract9.sol	 killed 
ACLDataLocmemory1.sol	 live 
ACLErrorHandle2.sol	 killed 
ACLErrorHandle4.sol	 killed 
ACLErrorHandle6.sol	 killed 
ACLEventDelMut1.sol	 killed 
ACLEventDelMut2.sol	 killed 
ACLEventDelMut3.sol	 killed 
ACLFunctionTypeMut10.sol	 live 
ACLFunctionTypeMut12.sol	 killed 
ACLFunctionTypeMut14.sol	 live 
ACLFunctionTypeMut2.sol	 killed 
ACLFunctionTypeMut20.sol	 live 
ACLFunctionTypeMut24.sol	 live 
ACLFunctionTypeMut26.sol	 live 
ACLFunctionTypeMut4.sol	 killed 
ACLFunctionTypeMut6.sol	 killed 
ACLFunctionVisMut10.sol	 killed 
ACLFunctionVisMut11.sol	 killed 
ACLFunctionVisMut13.sol	 live 
ACLFunctionVisMut16.sol	 live 
ACLFunctionVisMut19.sol	 killed 
ACLFunctionVisMut22.sol	 live 
ACLFunctionVisMut23.sol	 killed 
ACLFunctionVisMut24.sol	 killed 
ACLFunctionVisMut25.sol	 live 
ACLFunctionVisMut26.sol	 killed 
ACLFunctionVisMut27.sol	 killed 
ACLFunctionVisMut28.sol	 live 
ACLFunctionVisMut29.sol	 killed 
