MetaCoinAssignmentMut1.sol	 killed 
MetaCoinAssignmentMut10.sol	 killed 
MetaCoinAssignmentMut11.sol	 killed 
MetaCoinAssignmentMut12.sol	 killed 
MetaCoinAssignmentMut13.sol	 killed 
MetaCoinAssignmentMut14.sol	 killed 
MetaCoinAssignmentMut15.sol	 killed 
MetaCoinAssignmentMut16.sol	 killed 
MetaCoinAssignmentMut17.sol	 killed 
MetaCoinAssignmentMut18.sol	 killed 
MetaCoinAssignmentMut19.sol	 killed 
MetaCoinAssignmentMut2.sol	 live 
MetaCoinAssignmentMut20.sol	 killed 
MetaCoinAssignmentMut21.sol	 live 
MetaCoinAssignmentMut22.sol	 killed 
MetaCoinAssignmentMut23.sol	 live 
MetaCoinAssignmentMut24.sol	 live 
MetaCoinAssignmentMut3.sol	 killed 
MetaCoinAssignmentMut4.sol	 killed 
MetaCoinAssignmentMut5.sol	 live 
MetaCoinAssignmentMut6.sol	 killed 
MetaCoinAssignmentMut7.sol	 killed 
MetaCoinAssignmentMut8.sol	 live 
MetaCoinAssignmentMut9.sol	 killed 
MetaCoinBinMut1.sol	 killed 
MetaCoinBinMut2.sol	 live 
MetaCoinBinMut3.sol	 killed 
MetaCoinBinMut4.sol	 live 
MetaCoinBinMut5.sol	 killed 
MetaCoinEventDelMut1.sol	 live 
MetaCoinFunctionTypeMut2.sol	 live 
MetaCoinFunctionTypeMut4.sol	 live 
MetaCoinFunctionVisMut4.sol	 killed 
MetaCoinFunctionVisMut5.sol	 killed 
MetaCoinFunctionVisMut6.sol	 live 
MetaCoinFunctionVisMut7.sol	 killed 
MetaCoinFunctionVisMut8.sol	 killed 
MetaCoinFunctionVisMut9.sol	 live 
Live: 13
Killed: 25
Total: 38
Mutation Score: 0.6578947368421053
